NO cub3d_tester/textures/north_texture
SO cub3d_tester/textures/south_texture
WE cub3d_tester/textures/west_texture
EA cub3d_tester/textures/east_texture

F 220,100,0
C 225,30,0

111111
100101
101Q01
1100N1
111111