NO textures/wall.xpm
SO textures/wall.xpm
WE textures/wall.xpm
EA textures/wall.xpm

F 116,81,6
C 0,0,0

1111111
1000101
1000101
10001N1
1000001
1111111