NO cub3d_tester/textures/north_texture
SO cub3d_tester/textures/south_texture
WE cub3d_tester/textures/west_texture
EA cub3d_tester/textures/east_texture

F 220,100,0
C 225,30,0

111111
1001W1
1S1001
1E00N1
111111