NO cub3d_tester/textures/north_texture
SO cub3d_tester/textures/south_texture
WE cub3d_tester/textures/west_texture
EA cub3d_tester/textures/east_texture

F 220,100,0
C 225,30,0

        1111111111111111111111111
    0   1000000000110000000000001
        1011000001110000000000001
        1001000000000000000000001
111111111011000001110000000000001
100000000011000001110111111111111
11110111111111011100000010001
11110111111111011101010010001
11000000110101011100000010001
10000000000000001100000010001
10000000010111001101010010001
110000011111 1111111011110N0111
11110111         101111010001
11111111   111   111111111111