NO textures/checker_north.xpm
SO textures/checker_south.xpm
WE textures/checker_west.xpm
EA textures/checker_east.xpm

F 220,100,0
C 225,30,0

111111
100111
1010
1N0111
111111