NO textures/checker_north.xpm
SO textures/checker_south.xpm
WE textures/checker_west.xpm
EA textures/checker_east.xpm

F 220,100,0
C 225,30,0

110111
100100
101001
1100N1
111111