NO textures/north_texture
SO textures/south_texture
WE textures/west_texture
EA textures/east_texture

F 220,100,0
C 225,30,0

        1111111111111111111111111
        10000000001100000000000011111111111
        10110000011100000000000000000000001
        10010000000000000000000011111111101
111111111011000001110000000000001       101
100000000011000001110111111111111       101
11110111111111011100000010001           101
11110111111111011101010010001            01
11000000110101011100000010001           101
10000000000000001100000010001           101
1000000001011100110101001000111111111111101
110000011111 1111111011110N0000000000000001
11110111         10111101000111111111111111
11111111   111   111111111111